17
39
111112111111111111111111111111111111111
100000000100000100111001000101101110001
101010101111010160001011000100000100101
101011100001010010100001010101101110101
100010001011011110101011010101001010101
111010100000000510001000010101111010001
100010101111010111101010110100100010111
101000001000000001001010100101101010101
101101101011011101011010110100101010101
100000101001010001010010000001101010101
101011101101110101010110101010001010001
101010001100000001010100101010101010101
101000101001101101010101101000101010101
100010100011000001000000001010100000001
101000101001101101010101101000101010101
100010100011000001000000001010100000001
111111111111111111111111111111111111111