11
14
11111111111111
10100000010001
10111010111101
10101110000101
10001000111101
11101010000002
10001010111101
10100000100101
10111110101101
10000010100001
11111111111111