15
39
111111111111111111111111111111111111111
101000000100011111111000000101100000001
101110101111011160001011010101101100102
101011100001011111100011010101101101101
100010001111011111101011010101101011101
111010100010000511100000010101111010001
100010101111011111101010110101100010111
101000001000000001111010110101101010111
101111101011011101111010110100101010111
100000101001011101110000000001101010101
111011111101011001010110101010001010001
111010001100000001110100001010001010101
111000101001101101110101111000101010101
111011100011100001110000001110001000001
111111111111111111111111111111111111111