15
39
111111111111111111111111111111111111111
101000000100000111111001000101101110001
101110101111010160101011010100000100102
101011100001010010100001010101101110101
100010001111011110101011010101001011101
111010100010000510001000010101111010001
100010101111011111101010110100100010111
101000001000001001001010100101101010101
101111101011011101011010110100101010101
100000101001010001010010000001101010101
111011111101111101010110101010001010001
101010001100000001010100101010101110101
101000101001101101010101111000101010101
100010100011000001000000001010100000001
111111111111111111111111111111111111111