16
29
111111111111111111111111111
101500000100011111111000111
101110101111011150001011111
101011100001011111101011011
100010001111011111100011111
111010100000000511101111011
100010101111011111151115111
101000001001000001111110111
101111101011011101111110111
100000101001011101115000111
111011111101111011011111111
111011011100000001111151111
111005111001101101111101111
111011101111100001111100002
111111111111111111111111111