15
27
111111111111111111111111111
101000000100011111111000011
101110101111011160001011011
101011100001011111100011011
100010001111011111101011011
111010100010000511100000011
100010101111011111101010111
101000001000000001111010111
101111101011011101111010111
100000101001011101110000001
111011111101011001011111101
111010001100000001111100001
111000101001101101111101111
111011100011100001111100002
111111111111111111111111111